       #####       
       # @ #       
    #### * ###     
    #    *   #     
    # .**$** #     
    #    *   #     
    #### * ###     
       #   #       
       #####
Author: Howard Abed
Title: My Level
